1111111111111
10C0000E00P01
1000000000101

1111111111111