1111111111111111111111111111111111
100000000E0000C00000C0000000000001
1010010100100000101001000000010101
10100100101010100010010000P0010101
100000000C00C0000000000000000000C1
1111111111111111111111111111111111