1111111111111111111111111111111111111
10000000000000C00000C0000000000000001
100000000000000000M000000000000000001
10M0000000000000000000000000000000001
100000111110C0001111100M00111110C0001

100000100010000010E010000010001000001
1000001000100000100010000010001000001
1000000000000000000000C00000000000001
1000C00000001110000000111000000000001
1000000M0000111000M00011100000000M001
1000000000000000000000000000000000001
1000001111100000111110000011111000001
100000100010000010M010000010C01000001
10000010C0100000100010000010001000001
1000C00000000000000000000000000000001
10000000000011100000001110000000M0001
1000000000001C100000M0101000000000001
1M00000000001010000000101000000C00001
100000C000000000000000000000000000001
1000000000000000000000000000P00000001
1111111111111111111111111111111111111
