11111111111111111111111111111111111111
100M00000E0000C00000C0000M0000000000C1
10110101001000001010010000010000100M01
1010010010101010M001110000P00100000001
100000000C00C0000000000000000001C10001
11111111111111111111111111111111111111
