111111111
10P0000C1
100000011
1000001E1
111111111
